BBTBBBBBBBB
BBBBBBBBTBB
BBBBBTBBBBB
BBBBBBBBBBB
BBBBTBBBBBB
___________
_____P_____
___________
___________
_____A_____
