BBBBBBBBBBB
BBBBBBBBBDB
BBBBBBTBBBB
BTBBBBBBBBB
___________
_____P_____
___________
___________
___________
_____A_____
