BBBBBBBBBBB
BBBBBBBDBBB
BBBBTBBBBBB
BBBBBBBBBBB
___________
_____P_____
___________
___________
___________
_____A_____
