BBBBBBBBBDB
BBBBBBBBBBB
BBTBBBBBBBB
BBBBBBBBBBB
BBBBTBBBBBB
___________
_____P_____
___________
___________
_____A_____
