BBBTBBBBBBB
BBBBBBBDBBB
BBBBBBBBBBB
___________
_____P_____
___________
___________
___________
___________
_____A_____
